- - - - - - -
- R 6 6 6 D -
- 1 1 1 1 1 -
- 1 3 3 3 1 -
- - - - - - -
